............................
......By:hiitoin............
.....лллллллллллллллллл.....
.....л................л.....
.....л................л.....
.....лллллллллллллллл.л.....
.....ллллллллллллллл..л.....
.....л................л.....
.....лллллл.лллл.лллллл.....
.....лллл....л...лллл.л.....
.....лллл.ллллл.лллллл.....
.....л.........л......л.....
.....лл.лллл.лллллллллл.....
.....л.л...л..........л.....
.....л.....ллл.ллллл.лл.....
.....л.......л.ллллл.лл.....
.....л.......л..ллл...л.....
.....л.......л..л..лллл.....
.....л.........л.....л.....
.....л.лллллл.ллллллллл.....
.....л.л.....л........л.....
.....л.л..............л.....
.....л.л..............л.....
.....л................л.....
.....лллллл.лллллллл.лл..... 
.....л...л..л.........л.....
.....л...л.л..........л.....
.....л..л..л..........л.....
.....лллллллл.лллллл.лл.....
.....л.....л..л.......л.....
.....л.you..лл..ллллллл.....
.....л.win............л.....
.....ллллл.лллллллллллл.....
............................
.....л................л.....
.....лллллллллллллллл.л.....
.....ллллллллллллллл..л.....
.....л................л.....
.....лллллл.лллл.лллллл.....
.....лллл....л...лллл.л.....
.....лллл.ллллл.лллллл.....
.....л.........л......л.....
.....лл.лллл.лллллллллл.....
.....л.л...л..........л.....
.....л.....ллл.ллллл.лл.....
.....л.......л.ллллл.лл.....
.....л.......л..ллл...л.....
.....л.......л..л..лллл.....
.....л.........л.....л.....
.....л.лллллл.ллллллллл.....
.....л.л.....л........л.....
.....л.л..............л.....
.....л.л..............л.....
.....л................л.....
.....лллллл.лллллллл.лл..... 
.....л...л..л.........л.....
.....л...л.л..........л.....
.....л..л..л..........л.....
.....лллллллл.лллллл.лл.....
.....л.....л..л.......л.....
.....л.you..лл..ллллллл.....
.....л.win............л.....
.....ллллл.лллллллллллл.....
............................
............................
............................
............................
............................
............................
............................
............................
............................
............................
............................
............................
............................
............................
............................
............................
............................
............................
............................
............................
............................
............................
............................
............................
............................
............................
............................
............................
............................
............................
............................
............................
............................
............................
............................
............................
............................
............................
............................
............................
............................
............................
....Wow.You.Win.Forreal.....
............................
............................
............................
............................
............................
............................
............................
............................
............................
............................
............................
............................
............................
............................
............................
............................
............................
............................
............................
............................
............................
............................
............................
............................
............................
............................
............................
............................
............................
............................
............................
............................
...ok.you.can.stop.now......
............................
............................
............................
............................
............................
............................
............................
............................
............................
............................
............................
............................
............................
............................
............................
............................
............................
............................
............................
............................
..........ok!!!!!...........
....you.can.stop.now........
............................
............................
............................
............................
............................
............................
............................
............................
...........pls.stop.........
...........it.burns.........
............................
............................
............................
............................
............................
............................
............................
............................
............................
............................
.....ok.i.will.stop.you.....
............................
............................
............................
............................
............................
............................
............................
............................
............................
ok.i.will.stop.you.with.wall
............................
............................
............................
............................
............................
............................
............................
..HaHaHa:)..................
.............................
лллллллллллллллллллллллллллл.
help.he.is.evil.:(...........
............................
............................
............................
............................
HAHAHA.I.WILL.KILL.YOU......
............................
............................
............................
............................
............................
............................
............................
............................
............................
............................
............................
............................
............................
............................
............................
............................
............................
....you.sre.safe.now........
............................ 
............................
............................
............................       
............................                                                                           